# # # # # # # # # # # # # # # # # # # # # # # # # # # # # # # #
# . . . . . . . . . . . . . . . . . . . . . . . . . . . . . . #
# . # . . . . . . . . . . . . . . . . . . . . . . . . . . . . #
# . @ . # . # . # . # . . . . . . . . . . . . . . . . . . . . #
# . # . # . # . # . # . . . . . . . . . . . . . . . . . . . . #
# . # . # . # . # . # . . . . . . . . . . . . . . . . . . . . #
# . # . # . # . # . # . . . . . . . . . . . . . . . . . . . . #
# . # . # . # . # . # . . . . . . . . . . . . . . . . . . . . #
# . # . # . # . # . # . . . . . . . . . . # # # # # # # . . . #
# . # . # . # . # . # . . . . . . . . . . # . . . . . # . . . #
# . # . # . # . # . # . . . . . . . . . . # . . . . . # . . . #
# . # # # # # # # # # . . . . . . # # # . # . . . . . # . . . #
# . # . . . . . . . . . . . . . . # . # . # . . . . . # . . . #
# . # . . . . . . . . . . . . . . # s # . # . . . . . # . . . #
# . # . . . . . . . . . . . . . . . . . . # # # s # # # . . . #
# . # # # # # # . . . . . . . . . . . . . . . . . . . . . . . #
# . . . . . . # . . . . . . . . . . . . . . . . . . . . . . . #
# . # # # # . # . . . . . . . . . . . . . . . . . . . . . . . #
# . # . . # . # . . . . . . . . . . . . . . . . . . . . . . . #
# . # . . # . # . . . . . . . . . . . . . . . . . . . . . . . #
# . # . . # . # . . . . . . . . . . . . . . . . . . . . . . . #
# . # . . # . # . . . . . . . . . . . . . . . . . . . . . . . #
# . # . . # . # . . . . . . . . . . . . . . . . . . . . . . . #
# . # . . . . . . . . . . . . . . . . . . . . . . . . . . . . #
# . # . . . . . . . . . . . . . . . . . . . . . . . . . . . . #
# . # . . # . # . . . . . . . . . . . . . . . . . . . . . . . #
# . # . . # . # . . . . . . . . . . . . . . . . . . . . . . . #
# . # . . # . # . . . . . . . . . . . . . . . . . . . . . . . #
# . # . . # . # . . . . . . . . . . . . . . . . . . . . . . . #
# . # # # # . # . . . . . . . . . . . . . . . . . . . . . . . #
# . . . . . . # . . . . . . . . . . . . . . . . . . . . . . . #
# # # # # # # # # # # # # # # # # # # # # # # # # # # # # # # #
d: portals - (2, 3): (2, 16);
d: sectors - (2, 3): (2, 16); (18, 13): (24, 14); (24, 14): (18, 13);
d: sprites - (1.5, 3): (0.01, 0, "test.jpg");
d: enemies - 